00000200002000002000000200000002
00000000000000000000000000000002
00000000000000000000000000000002
00000000000000000000000000000002
00000000000000000000000000000002
00000000000000000000000000000a02
a0000022222222222222222222211110
11000011111111111111111111000000
00000000000000000000000000100100
00000000000000000000000000100100
000000000000000a0000000000000000
000000000000000a0000010010000001
00000001111111110000010001111110
00000000000000000000010000000002
00000000000000000000010000000002
00000000000000000000010000000002
00000000000000000000010000000002
0a00000000000000000001000000ee02
1111111111111111111111000000ee02
2000000000000000000000000000ee02
20000000000000000000000000011112
200a0000000000000000000000000002
20111100000000000000000000000002
22222222222222222222222222222222
