20000000000000000000ee0000000002
20000000000000000000ee0000000002
20000000000000000000ee0a00000002
20000000000000000011111110000002
20a00000000000000000000000000002
21110000000002222222222222222222
20000000000000000000000000000002
22222220000000000000000000000002
20000000000000000000000000000002
20000000000000000000000000000002
20000000000000000000000000000002
20000000000000000000000000000002
11111111111111100001111111111111
20000000000000000000000000000002
20000000000000000000000000000002
20000000000000000000000000000002
2a00000000000000000000000000a002
11111111000011111111111111111111
20000000000000000000000000000002
20000000000000000000000000000002
20000000000000000000000000000002
20000000000000000000000000aa0002
20000000000000000000000001111102
22222222222222222222222222222222
