22222222222222222222222222222222
20000000000000000000000000000002
20000000000000000000000000000002
20000000000000000000000000000002
2000000000000a000000000000000002
20000020000111110000000200000002
2a000022222222222222222200000002
210000000000000000000000000ee002
200000000000000000000000000ee002
200000000000000000000000000ee002
20000000000000000000000000111102
20000000000000000000000000000002
20000000000000000000000000000002
20000000000000000000000000000002
20000000000000000000000000000002
11111111111111110000000000000002
22222222222222220000000000000002
20000000000000020000000000000002
200aaaaa000000000000000000000002
200aaaaa000000000000000000000002
200aaaaa000000000000000000000002
200aaaaa000000000000000000000002
20000000000000020000000000000002
22222222222222222222222222222222
