20000000000000000000000000000000
000020000001000a0a00000000000000
00000000020000010100000000000000
20000000000000000000000000000000
0000000000000000000000000a000000
0000000000000020000000a001000000
00000000000000000000001010000000
20000000000000000000000100000000
00000000000000000000000000000000
00000000000000000020000000000000
00000010000000000000000000000000
00000000000000000000200000000000
00000000000000000000002000000000
00100000000000000000000020000000
00000000000000000000000000020000
0200000aaaaa00000000000000000a00
000000000000000000000000000ee002
000200000000000000000000000ee200
000002000000000000000000000ee000
00000000200000000000000000200000
00000000000200002000020000000000
00000000000000000000000000000000
00100000000000000000000000000000
0000000000000000000000000000000a
